1,1,1,1,1,1,1,1,1,1,1,1,1,1,1,1,1,1,1,1,1,1,1,1,1,1,1,1,1,1,1,1,1,1,1,1,1,1,1,1,1,1,1,1,1
16,0,0,0,0,0,0,0,0,0,0,0,0,0,0,0,0,0,0,0,0,0,0,0,0,0,0,0,0,0,0,0,0,0,0,0,0,0,0,0,0,0,0,0,17
16,0,0,0,0,0,0,0,0,0,0,0,0,0,0,0,0,0,0,0,0,0,0,0,0,0,0,0,0,0,0,0,0,0,0,0,0,0,0,0,0,0,0,0,17
16,0,0,0,0,0,0,0,0,0,0,0,0,0,0,0,0,0,0,0,0,0,9,0,0,0,0,0,0,0,0,0,0,0,0,0,0,0,0,0,0,0,40,1,1
1,1,42,0,0,0,0,0,0,0,0,0,7,0,0,0,0,0,0,0,0,0,0,0,0,0,0,0,0,0,0,0,7,0,0,0,0,0,0,0,0,0,41,1,42
40,1,43,0,0,0,0,0,0,0,0,40,1,42,0,0,0,0,0,0,0,0,0,0,0,0,0,0,0,0,0,40,1,42,0,0,0,0,0,0,0,0,0,0,35
35,0,0,0,0,0,0,0,0,0,0,41,1,43,0,0,0,0,0,0,0,0,0,0,0,0,0,0,0,0,0,41,1,43,0,0,0,0,0,0,0,0,0,0,35
35,0,0,0,0,0,0,0,0,0,0,0,0,0,0,0,0,0,0,0,0,0,0,0,0,0,0,0,0,0,0,0,0,0,0,0,0,0,0,0,0,0,0,0,35
35,0,0,0,0,0,0,0,0,0,0,0,0,0,0,0,0,0,0,0,0,0,0,0,0,0,0,0,0,0,0,0,0,0,0,0,0,0,0,0,0,0,0,0,35
35,0,0,0,0,0,0,0,0,9,0,0,0,0,0,0,0,0,0,0,0,0,2,7,0,0,0,0,0,0,0,0,0,0,0,0,0,0,0,0,0,0,0,0,35
35,0,0,0,0,0,0,0,0,0,0,0,0,0,0,0,0,0,40,1,1,1,1,1,1,1,42,0,0,0,0,0,0,9,0,0,0,0,0,0,0,0,0,0,35
35,0,0,0,0,0,0,0,0,0,0,0,0,0,0,0,0,0,35,0,0,0,0,0,0,0,35,0,0,0,0,0,0,0,0,0,0,0,0,0,0,0,0,0,35
35,0,0,0,0,0,0,0,0,0,0,0,0,0,0,0,0,0,41,1,1,1,1,1,1,1,43,0,0,0,0,0,0,0,0,0,0,0,0,0,0,0,0,0,35
35,0,0,0,0,0,0,0,0,0,0,0,0,0,0,0,0,0,0,0,0,0,0,0,0,0,0,0,0,0,0,0,0,0,0,0,0,0,0,0,0,0,0,0,35
35,0,0,0,0,0,0,0,0,0,0,0,0,0,0,0,0,0,0,0,0,0,0,0,0,0,0,0,0,0,0,0,0,0,0,0,0,0,0,0,0,0,0,0,35
35,0,0,0,0,0,0,0,0,0,7,0,0,0,0,0,0,0,0,0,0,0,7,0,0,0,0,0,0,0,0,0,0,0,0,7,0,0,0,0,0,0,0,0,35
35,4,4,4,4,40,1,1,1,1,1,1,1,42,4,4,4,4,4,4,4,4,4,4,4,4,4,4,4,4,4,40,1,1,1,1,1,1,1,42,4,4,4,4,35
35,4,4,4,4,35,0,0,0,0,0,0,0,35,4,4,4,4,4,4,4,4,4,4,4,4,4,4,4,4,4,35,0,0,0,0,0,0,0,35,4,4,4,4,35
35,4,4,4,4,41,1,1,1,1,1,1,1,43,4,4,4,4,4,4,4,4,4,4,4,4,4,4,4,4,4,41,1,1,1,1,1,1,1,43,4,4,4,4,35
35,0,0,0,0,0,0,0,0,0,0,0,0,0,0,0,0,0,0,0,0,0,0,0,0,0,0,0,0,0,0,0,0,0,0,0,0,0,0,0,0,0,0,0,35
35,0,0,0,0,0,0,0,0,0,0,0,0,0,0,0,0,0,0,0,0,0,0,0,0,0,0,0,0,0,0,0,0,0,0,0,0,0,0,0,0,0,0,0,35
35,0,0,0,0,0,0,0,0,0,0,0,0,0,0,0,0,0,0,0,0,0,7,0,0,0,0,0,0,0,0,0,0,0,0,0,0,0,0,0,0,0,0,0,35
35,0,0,0,0,0,0,0,0,9,0,0,0,0,0,0,0,0,40,1,1,1,1,1,1,1,42,0,0,0,0,0,0,0,9,0,0,0,0,0,0,0,0,0,35
35,0,0,0,0,0,0,0,0,0,0,0,0,0,0,0,0,0,35,0,0,0,0,0,0,0,35,0,0,0,0,0,0,0,0,0,0,0,0,0,0,0,0,0,35
35,0,0,0,0,0,0,0,0,0,0,0,0,0,0,0,0,0,41,1,1,1,1,1,1,1,43,0,0,0,0,0,0,0,0,0,0,0,0,0,0,0,0,0,35
35,0,0,0,0,0,0,0,0,0,0,0,0,0,0,0,0,0,0,0,0,0,0,0,0,0,0,0,0,0,0,0,0,0,0,0,0,0,0,0,0,0,0,0,35
35,0,0,0,0,0,0,0,0,0,0,0,0,0,0,0,0,0,0,0,0,0,0,0,0,0,0,0,0,0,0,0,0,0,0,0,0,0,0,0,0,0,0,0,35
35,0,0,0,0,0,0,0,0,0,0,0,0,0,0,0,0,0,0,0,0,0,0,0,0,0,0,0,0,0,0,0,0,0,0,0,0,0,0,0,0,0,0,0,35
35,0,0,0,0,0,0,0,0,0,0,7,0,0,0,0,0,0,0,0,0,0,0,0,0,0,0,0,0,0,0,0,0,0,7,0,0,0,0,0,0,0,0,0,35
41,1,1,1,1,1,1,1,1,1,1,1,1,1,1,1,1,1,1,1,1,1,1,1,1,1,1,1,1,1,1,1,1,1,1,1,1,1,1,1,1,1,1,1,43
