40,1,1,1,1,1,1,1,1,1,1,1,1,1,1,1,1,1,1,1,1,1,1,1,1,1,1,1,1,42
43,0,0,0,0,0,0,0,0,0,0,0,0,0,0,0,0,0,0,0,0,0,0,0,0,0,0,0,0,41
25,0,0,0,0,0,0,0,0,0,0,0,0,0,0,0,0,0,0,0,0,0,0,0,0,0,0,0,0,24
25,0,0,0,0,0,0,0,0,0,0,9,0,0,0,0,0,9,0,0,0,0,0,0,0,0,0,0,0,24
40,39,0,0,0,0,0,0,0,0,0,0,0,0,0,0,0,0,0,0,0,0,0,0,0,0,0,0,38,42
35,0,38,39,0,0,0,0,0,0,0,0,0,0,0,0,0,0,0,0,0,0,0,0,0,0,38,39,0,35
35,0,0,0,38,1,39,0,0,0,0,0,0,0,0,0,0,0,0,0,0,0,0,38,1,39,0,0,0,35
35,0,0,0,0,0,0,0,0,7,0,0,0,0,0,0,0,0,0,0,0,7,0,0,0,0,0,0,0,35
35,0,9,0,0,0,0,0,38,39,0,0,0,0,0,0,0,0,0,0,38,39,0,0,0,0,9,0,0,35
35,0,0,0,0,0,0,0,0,0,0,0,0,0,0,0,0,0,0,0,0,0,0,0,0,0,0,0,0,35
35,0,0,0,0,38,39,0,0,0,0,0,0,0,0,0,0,0,0,0,0,0,0,38,39,0,0,0,0,35
35,38,39,0,0,0,0,0,0,0,0,0,0,0,7,2,0,0,0,0,0,0,0,0,0,0,0,38,39,35
35,0,0,0,0,0,0,0,0,0,0,0,0,38,1,1,39,0,0,0,0,0,0,0,0,0,0,0,0,35
35,0,0,7,0,0,0,0,0,0,0,0,0,0,0,0,0,0,0,0,0,0,0,0,0,0,7,0,0,35
35,0,0,38,39,0,0,0,0,0,0,0,0,0,0,0,0,0,0,0,0,0,0,0,0,38,39,0,0,35
35,0,0,0,0,36,0,0,0,0,0,0,0,0,0,0,0,0,0,0,0,0,0,0,36,0,0,0,0,35
35,0,0,0,0,41,39,0,0,0,0,0,0,0,0,0,0,0,0,0,0,0,0,38,43,0,0,0,0,35
35,0,0,0,0,0,0,36,0,0,0,0,0,0,0,0,0,0,0,0,0,0,36,0,0,0,0,0,0,35
35,0,0,0,9,0,0,41,39,0,0,0,0,0,0,0,0,0,0,0,0,38,43,0,0,0,9,0,0,35
41,1,1,1,1,1,1,1,1,1,1,39,0,0,0,0,0,0,38,1,1,1,1,1,1,1,1,1,1,43
